1111111111111111111111111111111111
1000000000000000000000000000000001
10P00000000C00000000000000C0000001
1000000000000000001100000000000001
10000C0000000000E00000000000000001
10000001e0000000000000011000000001
1000000110000000000000000100000001
1000000100000000000000000000000001
100000000C000000000000000011001001
1000000000000000011110000001100001
1000000000000000000000000000000001
1000e00000000000000000000000000001
1001100000000000000C00000000000001
100111000E000000000000000000000001
10C1000000000000000000000E00000001
111111000000ee000000111111111C0001
10e01000000000000000E0000000000001
1000100C000000000e0000000000000e01
100000000000000000C000000000000001
1111111111111111111111111111111111