11111111111111111111111
1C010000000000100000001
1000100000000000000C001
11011100e0111100C000001
1E000000001111000001001
111111110e011100P000001
10000000000001000000001
10C00000000001001100001
11011100e0111100000C001
10000000000C00000000001
11111111111111111111111