11111111111
1P0000000E1
10110001101
1010C000101
100e0100001
10001110001
100001e0e01
10100000101
1C110001101
100000C0001
11111111111