111111111
1C0E10e01
10000e001
1P1101E01
1C1000001
111111111