111111111
100C00001
1P00010E1
10eC00001
111111111