11111111111
11110C01111
11110001111
11110101111
11110001111
10000000001
1C010P010E1
10000000001
11110101111
11110001111
11110E01111
11111111111